☠️ Careful! But wait... something is here.

⠀⠀⠀⠀⠀⢀⣤⣶⣾⣿⣿⣿⣷⣶⣤⡀⠀⠀⠀⠀⠀
⠀⠀⠀⠀⢰⣿⣿⣿⣿⣿⣿⣿⣿⣿⣿⣿⡆⠀⠀⠀⠀
⠀⠀⠀⠀⣿⣿⣿⣿⣿⣿⣿⣿⣿⣿⣿⣿⣿⠀⠀⠀⠀
⠀⠀⠀⠀⢸⣿⣿⣿⣿⣿⣿⣿⣿⣿⣿⣿⡏⠀⠀⠀⠀
⠀⠀⠀⠀⢰⡟⠛⠉⠙⢻⣿⡟⠋⠉⠙⢻⡇⠀⠀⠀⠀
⠀⠀⠀⠀⢸⣷⣀⣀⣠⣾⠛⣷⣄⣀⣀⣼⡏⠀⠀⠀⠀
⠀⠀⣀⠀⠀⠛⠋⢻⣿⣧⣤⣸⣿⡟⠙⠛⠀⠀⣀⠀⠀
⢀⣰⣿⣦⠀⠀⠀⠼⣿⣿⣿⣿⣿⡷⠀⠀⠀⣰⣿⣆⡀
⢻⣿⣿⣿⣧⣄⠀⠀⠁⠉⠉⠋⠈⠀⠀⣀⣴⣿⣿⣿⡿
⠀⠀⠀⠈⠙⠻⣿⣶⣄⡀⠀⢀⣠⣴⣿⠿⠛⠉⠁⠀⠀
⠀⠀⠀⠀⠀⠀⠀⠉⣻⣿⣷⣿⣟⠉⠀⠀⠀⠀⠀⠀⠀
⠀⠀⠀⠀⢀⣠⣴⣿⠿⠋⠉⠙⠿⣷⣦⣄⡀⠀⠀⠀⠀
⣴⣶⣶⣾⡿⠟⠋⠀⠀⠀⠀⠀⠀⠀⠙⠻⣿⣷⣶⣶⣦
⠙⢻⣿⡟⠁⠀⠀⠀⠀⠀⠀⠀⠀⠀⠀⠀⠀⢿⣿⡿⠋
⠀⠀⠉⠀⠀⠀⠀⠀⠀⠀⠀⠀⠀⠀⠀⠀⠀⠀⠉⠀⠀