This is not a real key!

───────────────────────────────────
───────────▄▄█▀██▀█▄▄▄▄────────────
─────────▄█▀▀████▄▄█▀▀▀▀█▄▄────────
───────▄█░░░░░░░░░░░░░░░░░░█▄──────
─────▄██░░░░░░░░░░░░░░░░░░░░▀█▄────
────▄██░░░░░░░░░░░░░░░░░░░░░░░██───
────█▀░░░░░░░░▄░░░░░░░░░░▄░░░░░▀█▄─
───█▀░░░░▄▀▀▀▀░█░░░░░▄▀▀▀░▀▄░░░░░█▄
──██░░░░█░▄▀▀▄░█░░░░█░▄▀▀▄░░█░░░░██
─██░░░░░█░░▀▀░▄▀░░░░▀▄░▀▀░░▄▀░░░░░█
██▀░░░░░▀▀▀▀▀▀░░░░░░░░▀▀▀▀▀░░░░░░░█
██░░░░░░░░░░░░░▐░░░░░░░░░░░░░░░░░░█
█▀░░░░░░░░░░░░░▌░░░░▌░░░░░░░░░░░░░█
█░░░░░░░░░░░░░▐░▄░▄░▐░░░░░░░░░░░░░█
█░░░░░░░░▐░░░░░░░░░░░░░░░░░░░░░░░░█
█░░░░░░░░▌░░░░░░░░░░░░░░░░░░░░░░░██
█░░░░░░░▐░░▄▀▀▀▀▀▀▀▀▄░░░░░░░░░░░░██
─█░░░░░░░▄▀▄████████▄█▄░▌░░░░░░░██─
──█░░░░░░█▄█▄▄█▄▄█▄▄██▀░▐░░░░░▄██──
──▀▄░░░░░░▀█▄▄▄▄▄▄▄▄▀░░░░░░░▄█▀────
────█▄░░▀▄░░░░░░░░░░░░░░░░▄█▀──────
─────█▄▄░░▀░░░░░░░░░░░░░▄█▀────────
───────▀▀▀▀▀▀▀▀▀▀▀▀▀▀▀▀▀▀──────────
───────────────────────────────────
